Проверка: Ошибка для проверки

ОКР-ОШ-ЧТЕНИЕ-ИСХОДНОГО: Ошибка чтения исходного файла '%s': %s
ОКР-ИМПОРТ-НЕ-ПАПКА: Путь в 'импорт "%s"' должен указывать на папку: %s
ОКР-ИМПОРТ-ПУСТАЯ-ПАПКА: Пусть в импорте указывает на папку '%s', в которой нет исходных файлов
ОКР-ОШ-ИМЯ-МОДУЛЯ: Имя модуля '%s' не совпадает с именем исходного файла '%s'
ОКР-ОШ-МОДУЛИ-В-ПАПКЕ: Модули '%s' и '%s' в одной папке: %s

ЛЕК-ОШ-СИМ: Недопустимый символ %#U
ЛЕК-UTF8: Ошибка в UTF-8 кодировке
ЛЕК-МОДИФИКАТОР: Неверный модификатор
ЛЕК-НЕТ-*/: Блочный комментарий не завершен
ЛЕК-СТРОКА-ЗАВЕРШЕНИЕ: Нет завершающей кавычки у строкового или символьного литерала
ЛЕК-ОШ-ДЛИНА-СИМВОЛА: В символьном литерале должен быть ровно один символ
ЛЕК-ESCAPE-ЗАВЕРШЕНИЕ: Escape-последовательность не завершена
ЛЕК-ОШ-ESCAPE: Escape-последовательность не завершена
ЛЕК-ВЕЩ-БАЗА: Вещественный литерал должен быть десятичным

ПАР-ОЖИДАЛСЯ: Ожидалась лексема '%s'
ПАР-ДУБЛЬ-ВХОД: Вход в модуле может быть только один, см: %s
ПАР-ОШ-ОПИСАНИЕ: Описание не может начинатся с лексемы '%s'
ПАР-ОШ-РАЗД: Ожидался разделитель ';' или NL, а не '%s' 
ПАР-ОШ-ОПЕРАТОР: Оператор не может начинатся с лексемы '%s'
ПАР-ОШ-МОДИФИКАТОР: Непригодный модификатор: '%s'
ПАР-ОШ-МОД-АТРИБУТ: Непригодный атрибут модификатора: '%s'
ПАР-ОШ-ОПЕРАНД: Неверный операнд: '%s'
ПАР-ОШ-КОНСТ-БАЗА: Значение базовой константы должно быть целым литералом %s
ПАР-ОШ-ОП-ТИПА: Ошибочное описание типа, начинающееся с лексемы '%s'
ПАР-СМЕСЬ-МАССИВ: Недопустимая смесь пар и значений в композите массива
ПАР-ПЕРЕМ-ИНИТ: Отсутствует обязательная инициализация переменной или поля
ПАР-МЕСТО-ВАРИАДИК: Вариадик параметр (...Т) должен быть последним в списке параметров
ПАР-ОШ-ИСП-ОСТОРОЖНО: Использование небезопасной операции (с меткой 'осторожно') без метки у в заголовке модуля

СЕМ-ЦИКЛ-ИМПОРТА: Циклический импорт. Модуль '%s' прямо или косвенно импортирует сам себя.

СЕМ-УЖЕ-ОПИСАНО: Объект с именем '%s' уже есть в текущей область видимости
СЕМ-НЕ-НАЙДЕНО: Объект с именем '%s' не найден
СЕМ-НЕ-НАЙДЕН-МОДУЛЬ: Модуль '%s' не найден
СЕМ-НЕ-НАЙДЕНО-В-МОДУЛЕ: В модуле '%s' не найден объект с именем '%s'
СЕМ-ДОЛЖЕН-БЫТЬ-МОДУЛЬ: Объект по имени '%s' не обозначает модуль
СЕМ-ДОЛЖЕН-БЫТЬ-ТИП: Объект по имени '%s' не обозначает тип
СЕМ-НЕ-ЭКСПОРТИРОВАН: Объект '%s' не экспортирован из модуля '%s'
СЕМ-НЕ-НАЙДЕН-МЕТОД-ВЕКТОРА: Метод '%s' не определен для вектора

СЕМ-ДЛЯ-ПОЗЖЕ-НУЖЕН-ТИП: Для переменной или поля с поздней инициализацией тип должен быть задан
СЕМ-НЕТ-ПОЗЖЕ-ПОЛЯ: Значение поля '%s' с поздней инициализацией должно быть задано
СЕМ-ПОЗЖЕ-ЛОК-ПЕРЕМЕННАЯ: Поздняя инициализация не может быть задана для локальной переменной

СЕМ-ПОЛУЧАТЕЛЬ-НЕ-КЛАСС: Получатель метода должен быть классом
СЕМ-БАЗА-НЕ-КЛАСС: Базовый тип класса должен быть классом
СЕМ-ДУБЛЬ-В-КЛАССЕ: В классе уже определено поле или метод с именем '%s', см. %s
СЕМ-РАЗНЫЕ-ТИПЫ-МЕТОДОВ: Типы при перепределении метода '%s' не совпадают: %s
СЕМ-ТИП-ВЫРАЖЕНИЯ: Тип выражения должен быть '%s'
СЕМ-ВЫЗОВ-НЕ_ФУНКТИП: Неверный тип у вызова (%s), должен быть тип функции
СЕМ-ЧИСЛО-АРГУМЕНТОВ: Число аргументов вызова: %d, должно быть %d
СЕМ-ВАРИАДИК-ЧИСЛО-АРГУМЕНТОВ: Число аргументов вызова вариадик функции не может быть меньше %d, задано %d
СЕМ-РАЗВОРАЧИВАНИЕ-ТОЛЬКО-ВАРИАДИК: Оператор разворачивания '...' применим только для для аргумента вариадик функции
СЕМ-ОДНО-РАЗВОРАЧИВАНИЕ: Оператор разворачивания применим к единственному аргументу
СЕМ-ТИПЫ-ЭЛЕМЕНТОВ-НЕ-СОВПАДАЮТ: Типы элементов в операторе разворачивания должны совпадать: '%s' и '%s'

СЕМ-НЕСОВМЕСТИМО-ПРИСВ: Выражение не совместимо по присваиванию %s: '%s' := '%s'
СЕМ-ОШ-ТИП-ОПЕРАНДА: Недопустимый тип операнда '%s' для операции '%s'
СЕМ-ОПЕРАНДЫ-НЕ-СОВМЕСТИМЫ: Типы операндов не совместимы: '%s' %s '%s'
СЕМ-ОШ-УНАРНАЯ-ТИП: Неверный тип операнда '%s' для унарной операции '%s'
СЕМ-ОШ-ВЕРНУТЬ-ЛИШНЕЕ: В этом операторе 'вернуть' не должно быть выражения
СЕМ-ОШ-ВЕРНУТЬ-НУЖНО: В этом операторе 'вернуть' должно быть выражение
СЕМ-ПРЕРВАТЬ-ВНЕ-ЦИКЛА: Оператор 'прервать' должен быть в цикле
СЕМ-ЗНАЧЕНИЕ-НЕ-ИСПОЛЬЗУЕТСЯ: Значение выражения не используется
СЕМ-НЕ-ЗАВЕРШАЮЩИЙ: Последний оператор должен быть завершающим (вернуть, прервать, авария)

СЕМ-КОМПОЗИТ-НЕТ-ТИПА: Композит должен начинаться с типа
СЕМ-МАССИВ-КОМПОЗИТ-ОШ-ТИП: Тип в композите массива должен быть индексируемого типа (вектор)
СЕМ-МАССИВ-КОМПОЗИТ-ТИП-КЛЮЧА: Ключ в композите массива должен быть целого типа
СЕМ-ОЖИДАЛСЯ-ТИП-МАССИВА: Должен быть массив, вместо него '%s'
СЕМ-ОЖИДАЛСЯ-ТИП-ВЕКТОРА: Должен быть вектор, вместо него '%s'
СЕМ-ОШ-ТИП-ИНДЕКСА: Тип индекса должен быть целым, а не '%s'

СЕМ-КЛАСС-КОМПОЗИТ-ОШ-ТИП: Тип в композите класса должен быть типом класса
СЕМ-КЛАСС-КОМПОЗИТ-НЕТ-ПОЛЯ: В классе нет поля с именем '%s'
СЕМ-КЛАСС-КОМПОЗИТ-НЕ-ПОЛE: Ожидалось поле, а не метод
СЕМ-ОЖИДАЛСЯ-ТИП-КЛАССА: Должен быть тип класса, вместо него '%s'
СЕМ-ОЖИДАЛОСЬ-ПОЛЕ-ИЛИ-МЕТОД: В классе нет поля или метода с именем '%s'
СЕМ-ДОЛЖЕН-БЫТЬ-НАСЛЕДНИКОМ: Класс '%s' должен быть наследником класса '%s' 

СЕМ-ОШ-КОНСТ-ВЫРАЖЕНИЕ: Должно быть константное выражение
СЕМ-НЕ-ПРИСВОИТЬ: Не может быть левой частью присваивания (литерал, константа, композит или только для чтения)
СЕМ-ТИП-В-ВЫРАЖЕНИИ: Тип не может быть использован в этом выражении

СЕМ-СТДФУНК-ОШ-ЧИСЛО-АРГ: Неверное число аргументов в вызове стд. функции '%s', должно быть: %s
СЕМ-СТД-ДЛИНА-ОШ-ТИП-АРГ: Неверный тип аргумента в вызове стд. функции '%s', должен быть вектор или вариадик или Строка
СЕМ-СТД-ТЕГ-ОШ-АРГ: Ожидался тип или выражение (не может быть вариадиком)
СЕМ-СТД-НЕЧТО-ОШ-АРГ: Только для параметра типа '*'

СЕМ-ОШ-ПРИВЕДЕНИЯ-ТИПА: Недопустимое приведение типа '%s' к типу '%s'
СЕМ-ОШ-ОСТОРОЖНОГО-ПРИВЕДЕНИЯ: Осторожное приведение типа '%s' к типу '%s' не разрешено
СЕМ-ПРИВЕДЕНИЕ-ТИПА-К-СЕБЕ: Лишнее приведение типа, тип и так уже '%s'
СЕМ-ЗНАЧЕНИЕ-НЕ-В_ДИАПАЗОНЕ: Значение выходит за диапазон для типа '%s'
СЕМ-ДЛИНА-СТРОКИ-НЕ-1: Строковый литерал здесь должен из одного символа

ГЕН-ОШ-КОНФ-ФАЙЛА: Ошибка чтения конфигурационного файла генерации: %s
ГЕН-ОШ-НАСТРОЙКА: В конфигурационном файле '%s' не задана настройка для '%s'